,Total_Driving_RANK THIS WEEK,Total_Driving_RANK LAST WEEK,Total_Driving_PLAYER NAME,Total_Driving_EVENTS,Total_Driving_TOTAL,Total_Driving_DISTANCE RANK,Total_Driving_ACCURACY RANK
0,1,,Keegan Bradley,29,70,44,26
1,2,,Kyle Stanley,29,76,63,13
2,3,,Graham DeLaet,25,82,32,50
3,4,,Lucas Glover,26,88,51,37
4,T5,,Rickie Fowler,21,98,39,59
5,T5,,Rick Lamb,19,98,54,44
6,T7,,Jim Herman,25,106,95,11
7,T7,,Francesco Molinari,21,106,99,7
8,9,,Martin Laird,25,109,66,43
9,10,,Brendan Steele,25,112,41,71
10,11,,Kevin Streelman,26,113,84,29
11,T12,,Sergio Garcia,17,114,33,81
12,T12,,Hudson Swafford,28,114,22,92
13,T14,,Paul Casey,24,115,60,55
14,T14,,Boo Weekley,27,115,113,2
15,16,,Shane Lowry,16,116,74,42
16,17,,Russell Henley,27,120,56,64
17,18,,Patrick Cantlay,13,126,47,79
18,T19,,Emiliano Grillo,25,129,91,38
19,T19,,Gary Woodland,26,129,13,116
20,21,,Bubba Watson,22,130,21,109
21,22,,Sam Saunders,24,133,88,45
22,T23,,Jason Kokrak,28,134,20,114
23,T23,,Hunter Mahan,26,134,78,56
24,T25,,Jason Dufner,24,136,78,58
25,T25,,Jon Rahm,23,136,19,117
26,T25,,Richy Werenski,26,136,106,30
27,28,,Harold Varner III,31,137,29,108
28,T29,,Tony Finau,29,143,9,134
29,T29,,Xander Schauffele,28,143,15,128
30,31,,Rory Sabbatini,23,144,103,41
31,T32,,Billy Horschel,28,145,43,102
32,T32,,Kevin Kisner,28,145,122,23
33,T32,,J.J. Spaun,29,145,105,40
34,T35,,Julián Etulain,22,146,89,57
35,T35,,Robert Garrigus,26,146,36,110
36,T35,,Dustin Johnson,20,146,2,144
37,T35,,Ryan Moore,24,146,129,17
38,39,,James Hahn,28,147,86,61
39,T40,,Russell Knox,24,151,129,22
40,T40,,Tag Ridings,20,151,30,121
41,42,,J.J. Henry,29,152,83,69
42,T43,,Kevin Chappell,27,154,24,130
43,T43,,Ben Martin,27,154,102,52
44,T45,,Hideki Matsuyama,22,157,27,130
45,T45,,Sean O'Hair,25,157,58,99
46,T45,,Chez Reavie,28,157,152,5
47,T48,,William McGirt,28,158,152,6
48,T48,,Justin Rose,18,158,40,118
49,T50,,Daniel Berger,26,159,63,96
50,T50,,Luke List,31,159,4,155
51,T50,,Rory McIlroy,14,159,1,158
52,53,,Grayson Murray,30,160,12,148
53,54,,Anirban Lahiri,22,161,60,101
54,T55,,Matt Jones,20,164,28,136
55,T55,,Ryan Palmer,20,164,26,138
56,57,,Zach Johnson,23,165,140,25
57,58,,Jamie Lovemark,28,166,25,141
58,T59,,Chad Campbell,29,167,147,20
59,T59,,Bud Cauley,28,167,67,100
60,T59,,Adam Scott,16,167,18,149
61,T62,,Scott Brown,29,168,119,49
62,T62,,Brett Stegmaier,27,168,122,46
63,T64,,Bryson DeChambeau,31,170,46,124
64,T64,,Louis Oosthuizen,18,170,73,97
65,T64,,Jhonattan Vegas,29,170,35,135
66,T67,,Sung Kang,32,171,65,106
67,T67,,Shawn Stefani,26,171,84,87
68,69,,Chris Stroud,22,172,140,32
69,T70,,Adam Hadwin,28,173,110,63
70,T70,,Danny Lee,32,173,108,65
71,72,,Brooks Koepka,24,174,6,168
72,73,,Vaughn Taylor,26,175,161,14
73,74,,Morgan Hoffmann,29,176,86,90
74,T75,,Ryan Armour,20,177,176,1
75,T75,,Charley Hoffman,31,177,50,127
76,T75,,Justin Thomas,25,177,8,169
77,78,,Webb Simpson,28,179,145,34
78,T79,,Byeong Hun An,22,180,41,139
79,T79,,Marc Leishman,25,180,51,129
80,T79,,Nick Taylor,29,180,103,77
81,82,,Miguel Angel Carballo,22,181,127,54
82,T83,,John Huh,28,182,135,47
83,T83,,Smylie Kaufman,26,182,23,159
84,85,,Brandon Hagy,26,183,3,180
85,T86,,Blayne Barber,25,184,106,78
86,T86,,Matt Kuchar,26,184,148,36
87,T86,,Graeme McDowell,17,184,174,10
88,T86,,Trey Mullinax,28,184,11,173
89,T86,,Steve Wheatcroft,17,184,169,15
90,T91,,Alex Cejka,28,185,164,21
91,T91,,Jason Day,20,185,15,170
92,T91,,C.T. Pan,29,185,135,50
93,T91,,Kyle Reifers,32,185,146,39
94,T95,,Brian Campbell,20,186,67,119
95,T95,,Chris Kirk,28,186,138,48
96,T95,,David Lingmerth,23,186,114,72
97,T95,,Scott Piercy,22,186,74,112
98,T99,,Jordan Spieth,23,187,76,111
99,T99,,Johnson Wagner,26,187,127,60
100,T99,,Nick Watney,23,187,33,154
101,T102,,Mackenzie Hughes,31,188,81,107
102,T102,,Cameron Percy,23,188,95,93
103,T102,,Kevin Tway,27,188,9,179
104,T105,,K.J. Choi,25,189,163,26
105,T105,,Brian Harman,30,189,116,73
106,107,,David Hearn,29,190,166,24
107,T108,,Ryan Brehm,25,191,6,185
108,T108,,Pat Perez,26,191,111,80
109,T108,,Patrick Rodgers,27,191,15,176
110,T111,,Spencer Levin,31,192,174,18
111,T111,,J.T. Poston,28,192,77,115
112,T111,,Brian Stuard,31,192,189,3
113,114,,Scott Stallings,27,193,56,137
114,T115,,Ben Crane,26,194,178,16
115,T115,,Jim Furyk,18,194,190,4
116,T115,,Kelly Kraft,27,194,99,95
117,T115,,Andrew Loupe,21,194,5,189
118,T119,,Zac Blair,32,196,188,8
119,T119,,Søren Kjeldsen,17,196,187,9
120,T121,,Roberto Castro,25,198,170,28
121,T121,,Ken Duke,26,198,186,12
122,T121,,Andres Gonzales,24,198,45,153
123,T121,,Troy Merritt,28,198,114,84
124,T125,,Rafa Cabrera Bello,19,200,109,91
125,T125,,Jonathan Randolph,22,200,133,67
126,127,,J.B. Holmes,23,201,14,187
127,128,,Steven Alker,23,202,183,19
128,129,,Daniel Summerhays,29,205,139,66
129,130,,Tim Wilkinson,22,206,173,33
130,131,,Geoff Ogilvy,25,210,142,68
131,132,,D.A. Points,22,211,180,31
132,133,,Brian Gay,25,212,177,35
133,T134,,Jonas Blixt,25,214,120,94
134,T134,,Rod Pampling,22,214,131,83
135,T134,,Patrick Reed,29,214,72,142
136,T134,,Robert Streb,30,214,81,133
137,138,,Martin Flores,27,215,38,177
138,139,,Harris English,27,217,31,186
139,140,,Cody Gribble,28,218,58,160
140,T141,,Dominic Bozzelli,24,220,80,140
141,T141,,Bill Haas,25,220,97,123
142,T141,,Ollie Schniederjans,28,220,36,184
143,T141,,Charl Schwartzel,18,220,49,171
144,145,,Michael Kim,28,221,116,105
145,146,,Jimmy Walker,21,222,71,151
146,T147,,Fabián Gómez,21,223,148,75
147,T147,,Charles Howell III,23,223,62,161
148,T147,,Seung-Yul Noh,31,223,48,175
149,T147,,Seamus Power,25,223,51,172
150,151,,Peter Malnati,29,224,162,62
151,152,,Retief Goosen,19,227,101,126
152,153,,Michael Thompson,21,228,152,76
153,T154,,Brett Drewitt,19,229,144,85
154,T154,,Ian Poulter,20,229,159,70
155,156,,Sebastián Muñoz,17,230,67,163
156,157,,Branden Grace,20,231,111,120
157,T158,,Ryan Blaum,29,237,155,82
158,T158,,Jason Bohn,28,237,185,52
159,T158,,Stewart Cink,26,237,70,167
160,T158,,Tyrone Van Aswegen,32,237,133,104
161,162,,Cameron Smith,26,239,93,146
162,163,,Brandt Snedeker,15,242,168,74
163,164,,Matt Every,30,243,55,188
164,165,,Kevin Na,26,245,157,88
165,166,,Phil Mickelson,22,246,89,157
166,167,,Mark Hubbard,27,249,160,89
167,168,,Mark Anderson,20,254,156,98
168,T169,,Billy Hurley III,25,269,183,86
169,T169,,Patton Kizzire,28,269,91,178
170,T171,,Gonzalo Fernandez-Castaño,22,271,98,173
171,T171,,Brad Fritsch,18,271,126,145
172,173,,Aaron Baddeley,20,274,93,181
173,174,,Si Woo Kim,30,277,125,152
174,175,,Chad Collins,26,278,165,113
175,176,,Nicholas Lindheim,21,282,135,147
176,T177,,Greg Chalmers,28,283,181,102
177,T177,,Whee Kim,27,283,118,165
178,179,,Camilo Villegas,25,286,122,164
179,180,,Cameron Tringale,28,289,167,122
180,T181,,Wesley Bryan,28,297,172,125
181,T181,,Tom Hoge,17,297,148,149
182,183,,Derek Fathauer,27,298,142,156
183,184,,Ryo Ishikawa,20,303,120,183
184,185,,Bryce Molder,26,314,182,132
185,186,,Ricky Barnes,31,316,151,165
186,187,,Ernie Els,20,319,157,162
187,188,,Luke Donald,18,321,178,143
188,189,,Steven Bowditch,27,322,132,190
189,190,,Carl Pettersson,27,352,170,182
