,Ball_Striking_RANK THIS WEEK,Ball_Striking_RANK LAST WEEK,Ball_Striking_PLAYER NAME,Ball_Striking_ROUNDS,Ball_Striking_VALUE,Ball_Striking_TOTAL DRV RANK,Ball_Striking_GIR RANK
0,1,1,Henrik Stenson,56,10,2,8
1,2,2,Graham DeLaet,80,12,9,3
2,T3,T3,Billy Horschel,92,15,11,4
3,T3,T3,Hudson Swafford,75,15,4,11
4,5,5,Jhonattan Vegas,77,19,12,7
5,6,6,Adam Scott,68,20,10,10
6,7,7,Rory McIlroy,66,22,16,6
7,8,8,Justin Hicks,103,29,27,2
8,9,9,J.J. Henry,91,32,27,5
9,10,10,Kevin Stadler,90,33,24,9
10,11,11,Kevin Chappell,100,34,6,28
11,12,12,Boo Weekley,73,35,15,20
12,T13,T13,Lucas Glover,68,38,1,37
13,T13,T13,Bubba Watson,76,38,14,24
14,15,15,Nick Watney,80,44,12,32
15,T16,T16,Chad Campbell,57,45,44,1
16,T16,T16,Sergio Garcia,61,45,31,14
17,18,18,Hunter Mahan,88,49,3,46
18,19,19,Harris English,95,50,33,17
19,20,20,Bill Haas,107,51,36,15
20,21,21,Keegan Bradley,89,54,8,46
21,22,22,John Merrick,87,55,36,19
22,23,23,Russell Knox,92,60,38,22
23,T24,T24,Ryan Moore,86,61,38,23
24,T24,T24,Willy Wilcox,51,61,19,42
25,T26,T26,Andrew Svoboda,77,62,44,18
26,T26,T26,Bo Van Pelt,83,62,46,16
27,28,28,Kyle Stanley,87,64,20,44
28,29,29,Shawn Stefani,60,66,6,60
29,30,30,Louis Oosthuizen,50,72,18,54
30,31,31,Dustin Johnson,58,73,52,21
31,T32,T32,Jim Furyk,84,74,62,12
32,T32,T32,John Senden,99,74,49,25
33,34,34,Gary Woodland,93,78,27,51
34,T35,T35,Jim Herman,62,80,25,55
35,T35,T35,Nicholas Thompson,85,80,34,46
36,T37,T37,Zach Johnson,97,82,51,31
37,T37,T37,Ben Martin,80,82,20,62
38,39,39,Martin Laird,66,83,25,58
39,40,40,David Toms,64,94,81,13
40,41,41,Charley Hoffman,93,96,61,35
41,T42,T42,Matt Kuchar,91,97,57,40
42,T42,T42,Will MacKenzie,82,97,27,70
43,44,44,Michael Putnam,106,98,62,36
44,45,45,Brendan Steele,89,101,48,53
45,46,46,Ryan Palmer,85,103,57,46
46,47,47,Justin Rose,70,106,65,41
47,48,48,Heath Slocum,71,109,76,33
48,49,49,Robert Streb,75,111,42,69
49,50,50,Charlie Beljan,76,116,34,82
50,51,51,Daniel Summerhays,98,118,76,42
51,52,52,Camilo Villegas,95,120,81,39
52,53,53,Charles Howell III,106,121,95,26
53,54,54,Brendon de Jonge,109,125,22,103
54,T55,T55,Scott Brown,100,127,38,89
55,T55,T55,Ken Duke,80,127,93,34
56,T57,T57,John Peterson,62,131,60,71
57,T57,T57,Carl Pettersson,91,131,85,46
58,T59,T59,Derek Ernst,80,133,5,128
59,T59,T59,Josh Teater,90,133,47,86
60,61,61,Paul Casey,56,136,71,65
61,T62,T62,Martin Kaymer,65,137,38,99
62,T62,T62,Michael Thompson,74,137,69,68
63,64,64,David Hearn,97,138,83,55
64,65,65,Robert Garrigus,80,140,56,84
65,66,66,Rickie Fowler,91,142,42,100
66,67,67,Ángel Cabrera,69,144,54,90
67,68,68,Billy Hurley III,86,146,83,63
68,T69,T69,Brooks Koepka,56,147,57,90
69,T69,T69,Hideki Matsuyama,82,147,31,116
70,T69,T69,Jimmy Walker,98,147,119,28
71,72,72,Webb Simpson,87,149,72,77
72,73,73,Jason Kokrak,65,150,76,74
73,74,74,Brad Fritsch,50,152,65,87
74,75,75,Graeme McDowell,66,153,88,65
75,T76,T76,Jason Dufner,57,154,95,59
76,T76,T76,Kevin Streelman,79,154,17,137
77,78,78,Stewart Cink,91,156,99,57
78,79,79,Marc Leishman,81,159,79,80
79,T80,T80,Robert Allenby,83,164,137,27
80,T80,T80,"Ted Potter, Jr.",68,164,79,85
81,T82,T82,Bud Cauley,56,165,135,30
82,T82,T82,Chris Stroud,88,165,85,80
83,84,84,Jeff Maggert,54,166,99,67
84,T85,T85,George McNeill,79,167,106,61
85,T85,T85,Seung-Yul Noh,92,167,129,38
86,T85,T85,Cameron Tringale,111,167,122,45
87,88,88,John Huh,87,168,62,106
88,89,89,Davis Love III,74,170,70,100
89,90,90,Jason Day,54,171,53,118
90,91,91,Martin Flores,85,172,120,52
91,T92,T92,Russell Henley,92,178,22,156
92,T92,T92,Chris Kirk,105,178,49,129
93,T94,T94,Danny Lee,84,179,75,104
94,T94,T94,Wes Roach,67,179,67,112
95,96,96,Charl Schwartzel,64,180,54,126
96,97,97,Vijay Singh,83,181,108,73
97,98,98,Kevin Kisner,85,187,111,76
98,T99,T99,Jonathan Byrd,76,189,94,95
99,T99,T99,Jerry Kelly,80,189,118,71
100,101,101,Lee Westwood,57,191,68,123
101,102,102,Jamie Lovemark,64,193,99,94
102,103,103,Brian Stuard,91,194,72,122
103,104,104,Tim Clark,75,195,85,110
104,105,105,Kevin Tway,64,206,99,107
105,106,106,Jason Bohn,81,208,111,97
106,107,107,Trevor Immelman,84,215,138,77
107,108,108,Phil Mickelson,71,217,138,79
108,109,109,Kevin Na,94,218,120,98
109,110,110,Rory Sabbatini,82,219,145,74
110,111,111,Spencer Levin,59,220,111,109
111,T112,T112,William McGirt,96,222,117,105
112,T112,T112,Troy Merritt,62,222,135,87
113,114,114,John Rollins,84,223,127,96
114,T115,T115,Matt Jones,83,225,88,137
115,T115,T115,Mark Wilson,69,225,88,137
116,117,117,Brian Harman,111,227,116,111
117,118,118,Jeff Overton,80,228,164,64
118,T119,T119,Brice Garnett,92,230,147,83
119,T119,T119,Brendon Todd,108,230,111,119
120,T121,T121,James Hahn,82,231,111,120
121,T121,T121,Geoff Ogilvy,84,231,131,100
122,T121,T121,Brandt Snedeker,89,231,95,136
123,124,124,Scott Stallings,77,232,92,140
124,T125,T125,Ben Crane,81,235,105,130
125,T125,T125,J.B. Holmes,86,235,72,163
126,127,127,Andrew Loupe,65,236,95,141
127,128,128,Sean O'Hair,77,238,106,132
128,129,129,Steven Bowditch,93,241,108,133
129,T130,T130,Tommy Gainey,73,246,129,117
130,T130,T130,Y.E. Yang,79,246,88,158
131,T132,T132,Sangmoon Bae,76,249,103,146
132,T132,T132,Ricky Barnes,92,249,157,92
133,134,134,Ryo Ishikawa,75,251,159,92
134,135,135,Pat Perez,84,254,147,107
135,136,136,Ian Poulter,57,261,108,153
136,T137,T137,Briny Baird,50,263,133,130
137,T137,T137,Brian Davis,93,263,103,160
138,T137,T137,David Lingmerth,80,263,128,135
139,140,140,Scott Langley,95,268,154,114
140,141,141,Ben Curtis,77,272,122,150
141,T142,T142,D.A. Points,75,273,125,148
142,T142,T142,Patrick Reed,92,273,149,124
143,144,144,Tyrone Van Aswegen,79,277,164,113
144,145,145,Luke Guthrie,85,278,152,126
145,146,146,Johnson Wagner,69,282,167,115
146,147,147,Retief Goosen,94,285,161,124
147,148,148,K.J. Choi,80,287,133,154
148,149,149,Morgan Hoffmann,103,289,142,147
149,150,150,Roberto Castro,76,291,122,169
150,T151,T151,Troy Matteson,62,293,138,155
151,T151,T151,Bryce Molder,77,293,172,121
152,T153,T153,Luke Donald,57,294,150,144
153,T153,T153,Chesson Hadley,84,294,151,143
154,155,155,D.H. Lee,54,297,125,172
155,156,156,Jordan Spieth,102,298,146,152
156,157,157,Richard Lee,80,302,131,171
157,158,158,Matt Every,85,303,169,134
158,159,159,Gonzalo Fernandez-Castaño,83,304,138,166
159,160,160,Jim Renner,61,311,163,148
160,T161,T161,Stuart Appleby,92,312,167,145
161,T161,T161,Andres Romero,81,312,144,168
162,T163,T163,Erik Compton,88,313,171,142
163,T163,T163,Freddie Jacobson,91,313,162,151
164,165,165,Bronson La'Cassie,51,316,155,161
165,166,166,Ernie Els,85,317,158,159
166,167,167,Justin Leonard,75,319,143,176
167,T168,T168,Woody Austin,63,323,156,167
168,T168,T168,Tim Wilkinson,86,323,166,157
169,170,170,Aaron Baddeley,74,326,152,174
170,171,171,Jonas Blixt,64,332,170,162
171,172,172,Brian Gay,81,335,160,175
172,T173,T173,James Driscoll,71,340,176,164
173,T173,T173,Charlie Wi,72,340,175,165
174,175,175,Chad Collins,78,344,174,170
175,176,176,Greg Chalmers,85,346,173,173
176,177,177,Mike Weir,69,354,177,177
