,Total_Driving_RANK THIS WEEK,Total_Driving_RANK LAST WEEK,Total_Driving_PLAYER NAME,Total_Driving_EVENTS,Total_Driving_TOTAL,Total_Driving_DISTANCE RANK,Total_Driving_ACCURACY RANK
0,1,1,Jeff Brehaut,34,79,62,17
1,2,2,John Senden,28,94,23,71
2,T3,T3,Lucas Glover,30,99,6,93
3,T3,T3,Ted Purdy,35,99,76,23
4,T5,T5,Joe Durant,26,101,97,4
5,T5,T5,J.J. Henry,30,101,10,91
6,7,7,Jason Bohn,29,110,41,69
7,8,8,Craig Barlow,25,111,61,50
8,9,9,Brian Bateman,24,113,48,65
9,10,10,Bo Van Pelt,30,114,36,78
10,11,11,Robert Allenby,26,116,34,82
11,12,12,Harrison Frazar,25,117,18,99
12,13,13,Jay Williamson,33,118,85,33
13,T14,T14,Cameron Beckman,30,121,59,62
14,T14,T14,Geoff Ogilvy,26,121,7,114
15,T16,T16,Scott McCarron,27,123,39,84
16,T16,T16,Joey Sindelar,31,123,53,70
17,18,18,Vaughn Taylor,27,125,46,79
18,19,19,Tom Lehman,19,126,97,29
19,20,20,Mike Heinen,17,127,4,123
20,21,21,Zach Johnson,30,128,113,15
21,22,22,Roland Thatcher,23,129,43,86
22,23,23,Kent Jones,32,130,103,27
23,24,24,Pat Perez,32,134,54,80
24,25,25,John Rollins,29,137,101,36
25,26,26,Billy Mayfair,32,140,118,22
26,27,27,Notah Begay III,23,141,110,31
27,28,28,Ryan Palmer,33,142,29,113
28,29,29,Brent Geiberger,31,143,56,87
29,T30,T30,Bart Bryant,23,145,138,7
30,T30,T30,Steve Elkington,20,145,100,45
31,32,32,Mark Calcavecchia,24,148,56,92
32,33,33,Olin Browne,30,150,142,8
33,34,34,Phil Mickelson,22,151,30,121
34,T35,T35,Jonathan Kaye,25,152,62,90
35,T35,T35,Mark Wilson,19,152,138,14
36,T37,T37,Frank Lickliter II,27,154,94,60
37,T37,T37,Kenny Perry,23,154,26,128
38,39,39,Matt Gogel,25,155,113,42
39,T40,T40,Briny Baird,30,156,73,83
40,T40,T40,J.L. Lewis,32,156,83,73
41,T40,T40,Rocco Mediate,19,156,131,25
42,T40,T40,Tom Pernice Jr.,31,156,109,47
43,T40,T40,Duffy Waldorf,26,156,116,40
44,45,45,Arron Oberholser,23,159,122,37
45,46,46,Rich Beem,28,160,22,138
46,T47,T47,Chris Smith,33,161,5,156
47,T47,T47,Kevin Sutherland,27,161,105,56
48,T47,T47,Hidemichi Tanaka,27,161,150,11
49,T50,T50,Jonathan Byrd,27,162,28,134
50,T50,T50,Robert Gamez,31,162,85,77
51,T52,T52,Dennis Paulson,21,163,14,149
52,T52,T52,Vijay Singh,29,163,13,150
53,T54,T54,Retief Goosen,16,164,38,126
54,T54,T54,Brian Kortan,24,164,47,117
55,T56,T56,Richard Johnson,32,165,131,34
56,T56,T56,Davis Love III,24,165,14,151
57,58,58,Stuart Appleby,25,167,42,125
58,59,59,Woody Austin,29,168,56,112
59,60,60,D.J. Brigman,27,169,65,104
60,T61,T61,Steve Allan,33,170,11,159
61,T61,T61,Stephen Ames,27,170,89,81
62,T61,T61,David Branshaw,30,170,110,60
63,T61,T61,John Huston,20,170,103,67
64,65,65,José Coceres,20,172,166,6
65,66,66,Mark Hensby,29,173,122,51
66,T67,T67,Heath Slocum,31,175,157,18
67,T67,T67,Scott Verplank,24,175,173,2
68,69,69,Hunter Mahan,30,176,45,131
69,70,70,Charles Howell III,30,177,82,95
70,71,71,Kris Cox,26,178,16,162
71,T72,T72,Glen Day,33,179,107,72
72,T72,T72,Kirk Triplett,24,179,167,12
73,T74,T74,Tim Clark,26,181,168,13
74,T74,T74,Roger Tambellini,28,181,21,160
75,T76,T76,Jeff Maggert,20,183,148,35
76,T76,T76,Hirofumi Miyase,27,183,163,20
77,78,78,Deane Pappas,22,184,32,152
78,79,79,Andre Stolz,20,185,20,165
79,80,80,Justin Leonard,25,187,134,53
80,81,81,Scott Simpson,18,188,169,19
81,T82,T82,Chad Campbell,28,189,87,102
82,T82,T82,Chris Couch,24,189,8,181
83,T82,T82,Matt Kuchar,28,189,94,95
84,T85,T85,Scott Hend,29,191,2,189
85,T85,T85,Skip Kendall,29,191,146,45
86,T85,T85,Patrick Sheehan,33,191,72,119
87,T85,T85,Tiger Woods,19,191,9,182
88,T89,T89,Luke Donald,21,192,162,30
89,T89,T89,Jason Dufner,28,192,65,127
90,T89,T89,Scott Hoch,17,192,154,38
91,T89,T89,Tag Ridings,18,192,12,180
92,T93,T93,Fred Funk,29,193,192,1
93,T93,T93,Jerry Kelly,29,193,172,21
94,T95,T95,Tom Byrum,25,195,190,5
95,T95,T95,Daniel Chopra,33,195,26,169
96,T95,T95,John Daly,22,195,3,192
97,T98,T98,Craig Bowden,30,196,193,3
98,T98,T98,Peter Lonard,23,196,54,142
99,T98,T98,Kevin Na,32,196,157,39
100,T101,T101,Hank Kuehne,30,197,1,196
101,T101,T101,Dicky Pride,23,197,153,44
102,T103,T103,Tommy Armour III,28,199,70,129
103,T103,T103,Danny Briggs,28,199,125,74
104,T105,T105,Fred Couples,16,201,35,166
105,T105,T105,Omar Uresti,28,201,191,10
106,T107,T107,Robert Damron,28,202,178,24
107,T107,T107,Spike McRoy,33,202,145,57
108,T109,T109,John Cook,19,203,194,9
109,T109,T109,J.P. Hayes,27,203,152,51
110,T111,T111,Ernie Els,16,204,19,185
111,T111,T111,Sergio Garcia,18,204,33,171
112,T111,T111,Rod Pampling,26,204,50,154
113,T111,T111,Adam Scott,16,204,30,174
114,115,115,Tim Petrovic,32,205,97,108
115,116,116,Rich Barcelo,26,206,43,163
116,117,117,Pat Bates,32,207,181,26
117,T118,T118,Darren Clarke,16,208,78,130
118,T118,T118,Justin Rose,22,208,65,143
119,T120,T120,Shaun Micheel,27,209,93,116
120,T120,T120,Rory Sabbatini,26,209,48,161
121,T122,T122,Tom Carter,35,210,24,186
122,T122,T122,Alex Cejka,24,210,110,100
123,124,124,Carl Pettersson,28,211,64,147
124,T125,T125,Guy Boros,24,212,149,63
125,T125,T125,Jay Delsing,26,212,79,133
126,T125,T125,Brenden Pappas,34,212,17,195
127,T125,T125,Corey Pavin,23,212,196,16
128,T129,T129,Tim Herron,26,213,40,173
129,T129,T129,Jeff Sluman,28,213,165,48
130,131,131,Brett Quigley,31,214,37,177
131,132,132,Steve Pate,24,216,128,88
132,T133,T133,Chris DiMarco,27,217,176,41
133,T133,T133,Niclas Fasth,22,217,77,140
134,T135,T135,Ben Crane,27,219,125,94
135,T135,T135,Dan Olsen,31,219,25,194
136,T137,T137,Mathias Grönberg,32,220,50,170
137,T137,T137,David Morland IV,27,220,188,32
138,T137,T137,Gene Sauers,30,220,156,64
139,T140,T140,Arjun Atwal,30,221,73,148
140,T140,T140,Danny Ellis,26,221,101,120
141,T142,T142,Stephen Leaney,24,223,135,88
142,T142,T142,Loren Roberts,22,223,195,28
143,144,144,Joe Ogilvie,32,224,79,145
144,T145,T145,Carlos Franco,27,227,69,158
145,T145,T145,Neal Lancaster,33,227,52,175
146,T145,T145,Len Mattiace,25,227,173,54
147,T148,T148,Dudley Hart,23,228,113,115
148,T148,T148,David Toms,24,228,117,111
149,150,150,Steve Flesch,31,229,161,68
150,151,151,Russ Cochran,25,230,155,75
151,T152,T152,Nick Price,15,231,188,43
152,T152,T152,Esteban Toledo,36,231,182,49
153,154,154,Greg Chalmers,22,233,94,139
154,T155,T155,Bob Burns,30,235,180,55
155,T155,T155,Ben Curtis,20,235,138,97
156,157,157,Stewart Cink,28,238,70,168
157,T158,T158,Michael Allen,28,239,60,179
158,T158,T158,Lee Janzen,25,239,107,132
159,T158,T158,Mike Weir,22,239,138,101
160,T161,T161,Dan Forsman,28,240,142,98
161,T161,T161,Grant Waite,29,240,83,157
162,T163,T163,Tripp Isenhour,22,242,106,136
163,T163,T163,Jesper Parnevik,24,242,89,153
164,165,165,Mark Brooks,31,243,184,59
165,166,166,Mark O'Meara,17,245,187,58
166,T167,T167,Brian Gay,32,248,163,85
167,T167,T167,Kevin Muncrief,21,248,65,183
168,T169,T169,Steve Lowery,28,251,79,172
169,T169,T169,David Peoples,26,251,146,105
170,171,171,David Frost,26,252,186,66
171,T172,T172,Cliff Kresge,33,253,131,122
172,T172,T172,Dean Wilson,33,253,136,117
173,174,174,Jay Haas,23,259,183,76
174,175,175,Bernhard Langer,15,260,136,124
175,T176,T176,Blaine McCallister,27,261,151,110
176,T176,T176,Craig Perks,27,261,73,188
177,T178,T178,Shigeki Maruyama,26,264,157,107
178,T178,T178,John Riegger,17,264,120,144
179,180,180,K.J. Choi,24,266,120,146
180,181,181,Bob Estes,23,272,170,102
181,182,182,Freddie Jacobson,24,273,89,184
182,183,183,Bob Tway,26,275,170,105
183,184,184,Aaron Baddeley,27,278,87,191
184,185,185,Tommy Tolles,25,282,92,190
185,186,186,Billy Andrade,31,283,128,155
186,187,187,Ken Duke,30,287,124,163
187,188,188,Craig Parry,16,288,179,109
188,189,189,Todd Fischer,33,294,157,137
189,T190,T190,Paul Azinger,23,295,119,176
190,T190,T190,Todd Hamilton,27,295,128,167
191,192,192,Chris Riley,23,311,176,135
192,193,193,David Gossett,25,312,125,187
193,194,194,Brad Faxon,28,326,185,141
194,195,195,Steve Stricker,27,337,144,193
195,196,196,José María Olazábal,17,353,175,178
